1111111111111111111
1333333331333333331
1411311131311131141
1333333333333333331
1311313111113131131
1333313331333133331
1111311131311131111
2221312222222131222
1111312112112131111
0222322122212232220
1111312111112131111
2221312222222131222
1111312111112131111
1333333331333333331
1311311131311131131
1431333333333331341
1131313111113131311
1333313331333133331
1311111131311111131
1333333333333333331
1111111111111111111
